.................................
.################################
.#...............................
.#...............................
.#...............................
.#...............................
.#...............................
.#...............................
.################################