.................%#%%###%....%###%..
.%%%%%%%%%%%%%%%%%#%%###%%%%%%###%%.
.%................#......%%.......%.
.%................#......%%.......%.
.%................#......%%.......%.
%%.......................%%.......%.
##.......................%%.......%.
##...................###%%%.......%.
##...................###%%%.......%.
%%...................###%%%.......%.
.%.......................%%.......%.
%%.......................%%.......%.
##.......................%%.......%.
##.......................%%.......%.
##.......................%%.......%.
%%%%%%%...........................%.
.%...%%...........................%.
.%.......................#%.......%.
.%.......................#%.......%.
.%.......................#%.......%.
.%%%%%%%%%%%%%%%%%%%%%####%%#$#%%%%.
.....................%####%%#$#%....