########%#####%%######
########%#####%%######
##.....%%%....%%....##
##..................##
##..................##
##..................##
%%%.................##
##..................##
##...............$$$##
##############%%######
%%%%%%%%#....#%%%%%%%%
.......%#....#%.......
.......%%....%%.......
.......%#....#%.......
.......%#....#%.......
.......%##%%%%%.......
.......%##%%###.......