########%#####%%######
########%#####%%######
##.....%%%....%%....##
##..................##
##..................##
##..................##
%%%.................##
##..................##
##..................##
##############%%#...##
%%%%%%%%#....#%%#...##
.......%#....#%.....##
.......%%....%%.....##
.......%#....#%.....##
.......%#....#%.$$$.##
.......%##%%%%%#######
.......%##%%##########