####################
#..................#
#..................#
#..................#
#..................#
#..................#
#..................#
####################
.......#....#.......
.......##..##.......
.......%%..%%.......
.......##..##.......
.......#....#.......
.......#....#.......
.......#%%%%#.......