####################
#..................#
#..................#
#..................#
#..................#
#..................#
#..................#
####################
.......#....#.......
.......#....#.......
.......#....#.......
.......#....#.......
.......#....#.......
.......######.......
.......#%%%%#.......