####################
#..................#
#..................#
#..................#
#..................#
#..................#
#..................#
####################
....#.........#.....
....#.........#.....
....#.........#.....
....#.........#.....
....###########.....