########%#############
########%#############
##.....%%%....##....##
##..................##
##..................##
##..................##
##..................##
##..................##
##..................##
###...##########...###
%%%...%%#....#%%...%%#
#%.....%#....#%.....%#
#%.....%#....#%.....%#
#%.....%#....#%.....%#
#%.$$$.%#....#%.$$$.%#
#%%%%%%%##%%##%%%%%%%#
##########%%##########