##################################
#................................#
#................................#
#................................#
#........................#########
#................................#
#................................#
######...........................#
#....##..........................#
#.....##...........#.....#.......#
#......##................#.......#
#.......##...............#.......#
#........##..............#.......#
#.........####.....#$$$$$#.......#
#............##..................#
#.............##.................#
#..............##................#
#...............##...............#
#................##..............#
#.................#######$$$$$####
#..................#######$$$#####