##################################
#................................#
#................................#
#.............................####
#................................#
######...........................#
#....##..........................#
#.....##.........................#
#......##........................#
#.......##.......................#
#........##......................#
#.........##.......#####.........#
#..........##....................#
#...........##...................#
#............##..................#
#.............##.................#
#..............##................#
#...............##...............#
#................##..............#
##################################