..#%#..#%#..#%#..#%#..#%#..#%#..#%#.
.##%####%####%####%####%####%####%##
.#.................................#
.#.................................#
.#.................................#
.#..................%.....%%%%%%%%%%
.#..............................#%#.
.#..............................#%#.
.##%#...........................#%#.
..#%##..........................#%#.
%%%%.##.............%.....%.....#%#.
...%..##%#................#.....#%#.
...%...#%##...............#.....#%#.
...%%%%%%.##..............#.....#%#.
%%%%....%..##%#.....%$$$$$%.....#%#.
...%....%...#%##................#%#.
...%....%%%%%%.##...............#%#.
...%%%%%%....%..##%#............#%#.
%%%%....%....%...#%##...........#%#.
...%....%....%%%%%%.##..........#%#.
...%....%%%%%%....%..##%##$$$$$##%##
...%%%%%%....%....%...#%#..$$$..#%#.