##############################
#...............#...#........#
#...............#...#........#
#...............#...#.....####
##..............#...#........#
#.#.............#...#........#
#...............#...#........#
#...............#...#........#
#...............#...#........#
#...............#...#........#
#...............#####........#
#...............#####........#
#........#...#...............#
#............#...............#
#............#...............#
#............#...............#
#............#...............#
#.............#..............#
#..............#.............#
#...............#............#
##############################