....................................
.%%%%%%%%%%%%%%%%%%%%%%%%%%%%%%%%%%%
.%................%........%.......%
.%................%........%.......%
.%................%........%.......%
.%.........................%.......%
.%.........................%.......%
.%...................%%%...%.......%
.%...................%%%...%.......%
.%...................%%%...%.......%
.%.........................%.......%
.%.......................%%%....%%%%
.%.................................%
.%.................................%
.%.................................%
.%.................................%
.%.................................%
.%.......................%%........%
.%.......................%.........%
.%.......................%.........%
.%%%%%%%%%%%%%%%%%%%%%%%%%%%%%%%%%%%
....................................
...................%%%%%%%%%........