$$$$$$$$$$$$$$$%%%$$$$$$$$$$$$
$$$$$$$$$$$$$$$%%%$$$$$$$$$$$$
$$.............%%%..........$$
$$..........................$$
$$..........................$$
$$..........................$$
$$........................%%$$
$$........................%%$$
$$$$$$$......$$$$$$$$$$%%#%%$$
$$.................$$$$%%#%%$$
$$$................#%%%%%#%%$$
$##................$%%%%%#%%$$
$$$................$%%####%%$$
$$.................$%%#%%%%%$$
$$$$$$$$.....$$####$%%#%%%%%$$
$$....##............%%#%%...$$
$$..........................$$
%%%.........................$$
%%%.........................$$
%%%.................%%#%%...$$
$$$$$$##$$$$$$$$$$$$%%#%%$$$$$
$$$$$$$$$$$$$$$$$$$$%%#%%$$$$$