$$$%%%$$$$$$$$$$$$$$$$$$$$$$$
$$$%%%$$$$$$$$$$$$$$$$$$$$$$$.
$$.%%%......................$.
$$..........................$.
$$..........................$.
$$..........................$.
$$........................%%$.
$$........................%%$.
$$$$$$$......$$$$$$$$$$%%#%%$.
$$.................$$$$%%#%%$.
$$$................#%%%%%#%%$.
$##................$%%%%%#%%$.
$$$................$%%####%%$.
$$.................$%%#%%%%%$.
$$$$$$$$.....$$####$%%#%%%%%$.
$$....##............%%#%%...$.
$$..........................$.
%%%.........................$.
%%%.........................$.
%%%.................%%#%%...$.
.$$$$$##$$$$$$$$$$$$%%#%%$$$$.
.$$$$$$$$$$$$$$$$$$$%%#%%$$$$.