##############################
##############################
##...............##........###
##...............##........###
##...............##........###
###.....#........##......#####
###.....#................#####
###.....#................#####
###$...$#...##################
###$...$#........#############
###$...$#........##.......####
###$###$#........##.......####
#############....##...$$$$####
##........###.............####
##.........##.............####
##..........##..####%%#%%#####
##..........................##
##.....%%...................##
##.....#%%..................##
##.....##%%.................##
##########%%%%%%####%%#%%#%###
####################%%#%%#%###